R 1000 800
S ./path_to_the_sprite_texture
SO ./path_to_the_south_texture
NO ./path_to_the_north_texture
WE ./path_to_the_west_texture
EA ./path_to_the_east_texture
F 220,100,100
C 100,200,100
1111111111111
1001000000001
1000000000001
1000S00000001
1001000000001
1111111111111