R 1500 900
S ./path_to_the_sprite_texture
SO ./path_to_the_south_texture
NO ./path_to_the_north_texture
WE ./path_to_the_west_texture
EA ./path_to_the_east_texture
F 220,100,100
C 220,100,150
111111111
100000001
1000N0101
100100001
111111111