R 1500 900
S texture/ACtomnook_sprite.xpm 
SO texture/AC_wall1.xpm 
NO texture/AC_wall2.xpm
WE texture/AC_wall3.xpm
EA texture/AC_wall4.xpm
C 0,0,153
F 153,51,0 

 11111111111111111111
1100001110000100001011
1000001000000010000101
1100001000000020011001
11000000000N0000000001
 110000000000000111111
  11000000000001111
  10000000000000001
  11111111111111111111