R 1500 900
S texture/vulpix-sprite_1.xpm 
SO texture/space_wall_1.xpm 
NO texture/space_wall_2.xpm
WE texture/space_wall_3.xpm
EA texture/space_wall_4.xpm
F 50,0,50
C 0,0,0
1111111
1000001
1011101
101N101
1000101
1111121
1111111