R 1500 900
S texture/gray_stone_wall.xpm 
SO texture/gray_stone_wall.xpm 
NO texture/stone_wall.xpm
WE texture/leaves_wall.xpm
EA texture/red_brick_wall.xpm
C 0,100,255
F 200,200,100 
1111111
1000001
1011101
101N101
1000101
1111101
1111111