R 900 600
S texture/vulpix-sprite_1.xpm 
SO texture/gray_stone_wall.xpm 
NO texture/stone_wall.xpm
WE texture/leaves_wall.xpm
EA texture/red_brick_wall.xpm
F 50,204,55
C 55,0,255
// corriger pb si texte dans fichier
111111111111111111111111111111111111111111111111
100000000000000000000000000000000000000000000001
100000001000000000000000000000000000000000000001
100000001000000000000000000000000000000000000001
100010001000000010000011111111111111111111000001
100000001000000000000000000000000000000001000001
100001111111100000000000000000000000000001000001
100000010000000000001000111111111110001001000001
100000010000001000001000000000000000001001000001
100000010000001000001001000010100100001001000001
100000110000001000001001000012100100001001000001
100010100000000010001001000010100100001001000001
10000010000000000000100100000N000100001001000001
100000100010000000001001000000000100001001000001
100000100010000000001001000000000100001001000001
100000100010000000001001000000000100001001000001
100000100010000000001001000000000100001001000001
100000000010000000001000000000000000001001000001
100000000010000000001000000000000000001001000001
100000000010000000001001111111111111111001000001
100000000000000000001000000000000000000001000001
100000000000000000001000000000000000000001000001
111111111111111111111111111111111111111111111111