R 800 600
S texture/red_brick_wall.xpm   
SO texture/red_brick_wall.xpm
NO texture/stone_wall.xpm
WE texture/stone_wall.xpm
EA texture/red_brick_wall.xpm
C 0,100,255
F 200,200,100 
1111111111111111111111
1000000000000000000001
1000000000000000000001
1000010000000000010001
1000000000000000000001
1000000000S00000000001
1000000000000000000001
1000000000000000000001
1000000010000000000001
1000000000000000000001
1111111111111111111111