R 1200 900
S texture/vulpix_sprite.xpm 
SO texture/medieval_wall.xpm 
NO texture/stone_wall.xpm
WE texture/leaves_wall.xpm
EA texture/red_brick_wall.xpm
F 0,200,50
C 150,0,250
111111111111111111111111111111111111111111111111
100000000000000000001111111111111100000000000001
100000001000000000000000000000000000000000000001
100000001000000000000000000000000000000000000001
100010001000000010000011111111111111111111000001
100000001000000000000000000000000000000001000001
100001111111100000000000000000000000000001000001
100000010000000000001000111111111110001001000001
100000010000001000001000000000000000001001000001
100000010000001000001001000010100100001001000001
100000110000001000001001000012100100001001000001
100010100000000010001001000010100100001001000001
10000010000000000000100100000N000100001001000001
100000100010000100001001000000000100001001000001
100000100010000100001001000202020100001001000001
100000100010000100001001000000000100001001000001
100000100010000100001001000000000100001001000001
100000000010000100001000000000000000001001000001
100000000010000100001000000001110000001001000001
100000000010000100001001111111111111111001000001
100000000000000100001000000000000000000001000001
100000000000000100001000000000000000000001000001
111111111111111111111111111111111111111111111111