R 900 600
S texture/red_brick_wall.jpeg       
SO texture/red_brick_wall.jpeg
NO texture/red_bricks.jpeg
WE texture/stone_wall.jpeg
EA texture/red_bricks.jpeg
F 220,100,255
C 100,200,100
111111111111
100000000001
10000S000001
100000000001
111111111111