R 800 600
S ../texture/path_to_the_sprite_texture
SO ../texture/path_to_the_south_texture
NO ./path_to_the_north_texture
WE ./path_to_the_west_texture
EA ./path_to_the_east_texture
F 220,100,100
C 100,200,100
111111111
100010001
110000001
100N00001
100000001
111111111