R 1200 900
S texture/aliencartoon_sprite.xpm 
SO texture/space_wall_1.xpm 
NO texture/space_wall_2.xpm
WE texture/space_wall_3.xpm
EA texture/space_wall_4.xpm
F 50,0,50
C 0,0,0
        1111111111111111111111111
        1000000000110000000000001
        1011000001110000002000001
        100100000000000000N000001
111111111011000001110000000000001
100000000011000001110111111111111
11110111111111011100000010001
11110111111111011101010010001
11000000110101011100000010001
10002000000000001100000010001
10000000000000001101010010001
1100000111010101111101111000111
11110111 1110101 101111010001
11111111 1111111 111111111111