R 1500 900
S texture/ACtomnook_sprite.xpm 
SO texture/AC_wall1.xpm 
NO texture/AC_wall2.xpm
WE texture/AC_wall3.xpm
EA texture/AC_wall4.xpm
C 0,0,153
F 153,51,0 

1111111111111111111111
1000001110000100001011
1000001000000010100101
1100001000000020111001
10000000000N0000100001
1100000000000000100001
1000000000000000100001
1000000000000000000001
1111111111111111111111