R 1500 900
S texture/ACtomnook_sprite.xpm 
SO texture/AC_wall1.xpm 
NO texture/AC_wall2.xpm
WE texture/AC_wall3.xpm
EA texture/AC_wall4.xpm
C 0,0,153
F 153,51,0 


          1111111   
        11110001111
   11111110000100111 
  110000000200000011111
 11000000000000002110011
11111100000S00001111111
1100002000000000111
100000000000000100111111
11111111111111111111